":START_ID",":END_ID"
"758","250"
"750","251"
"751","252"
"759","253"
"752","254"
"753","255"
"754","256"
"760","257"
"755","258"
"756","259"
"757","260"
