":START_ID",":END_ID"
"239","86"
"236","87"
"240","88"
"237","89"
"238","90"
